12, 12, 12, 12, 12,  5,  0,  2, 16, 16, 16, 16, 16, 16, 16, 16, 16, 16, 16, 16, 16, 16, 16, 16, 16, 16, 16, 16, 16, 16, 16, 16, 16, 16, 16, 16, 16, 16, 16, 16, 16, 16, 16, 16, 16, 16, 16, 16, 16, 16
12, 12, 12, 12, 12,  5,  0,  2, 16, 16, 16, 16, 16, 16, 16, 16, 16, 16, 16, 16, 16, 16, 16, 16, 16, 16, 16, 16, 16, 16, 16, 16, 16, 16, 16, 16, 16, 16, 16, 16, 16, 16, 16, 16, 16, 16, 16, 16, 16, 16
12, 12, 12, 12, 12,  5,  0,  2, 16, 16, 16, 16, 16, 16, 16, 16, 16, 16, 16, 16, 16, 16, 16, 16, 16, 16, 16, 16, 16, 16, 16, 16, 16, 16, 16, 16, 16, 16, 16, 16, 16, 16, 16, 16, 16, 16, 16, 16, 16, 16
12, 12, 12, 12, 12,  5,  0,  2, 16, 16, 16, 16, 16, 16, 16, 16, 16, 16, 16, 16, 16,  4,  4,  4,  4,  4,  4,  4,  4,  4, 16, 16, 16, 16, 16, 16, 16, 16, 16, 16, 16, 16, 16, 16, 16, 16, 16, 16, 16, 16
12, 12, 12, 12, 12,  5,  0,  2, 16, 16, 16, 16, 16, 16, 16, 16,  2,  2,  2, 16, 16,  4,  4,  4,  4,  4,  4,  4,  4,  4, 16, 16, 16, 16, 16, 16, 16, 16, 16, 16, 16, 16, 16, 16, 16, 16, 16, 16, 16, 16
12, 12, 12, 12, 12,  5,  0,  2, 16, 16, 16, 16, 16, 16, 16, 66, 14, 14,  2, 16, 16, 16, 16, 16, 16, 16, 16, 16,  4,  4, 16, 16, 16, 16, 16, 16, 16, 16, 16, 16, 16, 16, 16, 16, 16, 16, 16, 16, 16, 16
12, 12, 12, 12, 12,  5,  0,  2, 16, 16, 16, 16, 16, 16, 16, 81, 14, 14,  2, 16, 16, 16, 16, 16, 16, 16, 16, 16,  4,  4, 16, 16, 16, 16, 16, 16, 16, 16, 16, 16, 16, 16, 16, 16, 16, 16, 16, 16, 16, 16
12, 12, 12, 12, 12,  5,  0,  2, 16, 16, 16, 16, 16, 16, 16, 81, 14, 14,  2, 16, 16, 16, 16, 16, 16, 16, 16, 16, 16, 16, 16, 16, 16, 16, 16, 16, 16, 16, 16, 16, 16, 16, 16, 16, 16, 16, 16, 16, 16, 16
12, 12, 12, 12, 12,  5,  0,  2, 16, 16, 16, 16, 16, 16, 16, 81, 14, 14,  2, 16, 16, 16, 16, 16, 16, 16, 16, 16, 16, 16, 16, 16, 16, 16, 16, 16, 16, 16, 16, 16, 16, 16, 16, 16, 16, 16, 16, 16, 16, 16
12, 12, 12, 12, 12,  5,  0,  2, 16, 16, 16, 16, 16, 16, 16, 63, 64, 64, 65, 16, 15, 15, 15, 16, 15, 15, 15, 16, 15, 15, 15, 16, 16, 16, 16, 16, 16, 16, 16, 16, 16, 16, 16, 16, 16, 16, 16, 16, 16, 16
12, 12, 12, 12, 12,  5,  0,  2, 16, 16, 16, 16, 16, 16, 16, 16, 16, 16, 16, 16, 15, 15, 15, 16, 15, 15, 15, 16, 15, 15, 15, 16, 16, 16, 16, 16, 16, 16, 16, 16, 16, 16, 16, 16, 16, 16, 16, 16, 16, 16
12, 12, 12, 12, 12,  5,  0,  2, 16, 16, 16, 16, 16, 16, 16, 16, 16, 16, 16, 16, 15, 15, 15, 16, 15, 15, 15, 16, 15, 15, 15, 16, 16, 16, 16,  0,  0,  0,  0, 16, 16, 16, 16, 16, 16, 16, 16, 16, 16, 16
12, 12, 12, 12, 12,  5,  0,  2, 16, 16, 16, 16, 16, 16, 16, 16, 16, 16, 16, 16, 15, 15, 15, 16, 15, 15, 15, 16, 15, 15, 15, 16, 16, 16, 16,  0,  0,  0,  0, 16, 16, 16, 16, 16, 16, 16, 16, 16, 16, 16
12, 12, 12, 12, 12,  5,  0,  2, 16, 16, 16, 16, 16, 16, 16, 16, 16, 16, 16, 16, 15, 15, 15, 16, 15, 15, 15, 16, 15, 15, 15, 16, 16, 16, 16,  0,  0,  0,  0, 16, 16, 16, 16, 16, 16, 16, 16, 16, 16, 16
12, 12, 12, 12, 12,  5,  0,  2, 16, 16, 16, 16, 16, 16, 16, 16, 16, 16, 16, 16, 15, 15, 15, 16, 15, 15, 15, 16, 15,  0,  0,  0, 16, 16, 16, 16, 16, 16, 16, 16, 16, 16, 16, 16, 16, 16, 16, 16, 16, 16
12, 12, 12, 12, 12,  5,  0,  2, 16, 16, 16, 16, 16, 16, 16, 16, 16, 16, 16, 16, 15, 15, 15, 16, 15, 15, 15, 16, 15,  0,  0,  0, 16, 16, 16, 16, 16, 16, 16, 16, 16, 16, 16, 16, 16, 16, 16, 16, 16, 16
12, 12, 12, 12, 12,  5,  0,  2, 16, 16, 16, 16, 16, 16, 16, 16, 16, 16, 15, 15, 15, 15, 15, 16, 15, 15, 15, 16, 15, 15, 15, 16, 16, 16, 16, 16, 16, 16, 16, 16, 16, 16, 16, 16, 16, 16, 16, 16, 16, 16
12, 12, 12, 12, 12,  5,  0,  2, 16, 16, 16, 16, 16, 16, 16, 16, 16, 16, 15, 15, 15, 15, 15, 16, 15, 15, 15, 16, 15, 15, 15, 16, 16, 16, 16, 16, 16, 16, 16, 16, 16, 16, 16, 16, 16, 16, 16, 16, 16, 16
12, 12, 12, 12, 12,  5,  0,  2, 16, 16, 16, 16, 16, 16, 16, 16, 16, 16, 16, 16, 15, 15, 15, 16, 15, 15, 15, 16, 15, 15, 15, 16, 16, 16, 16, 16, 16, 16, 16, 16, 16, 16, 16, 16, 16, 16, 16, 16, 16, 16
12, 12, 12, 12, 12,  5,  0,  2, 16, 16, 16, 16, 16, 16, 16, 16, 16, 16, 16, 16, 15, 15,  0,  0,  0,  0,  0,  0,  0,  0,  0, 16, 16, 16, 16,  0,  0,  0,  0, 16, 16, 16, 16, 16, 16, 16, 16, 16, 16, 16
12, 12, 12, 12, 12,  5,  0,  2, 16, 16, 16, 16, 16, 16, 16, 16, 16, 16, 16, 16, 15, 15,  0,  0,  0,  0,  0,  0,  0,  0,  0, 16, 16, 16, 16,  0,  0,  0,  0, 16, 16, 16, 16, 16, 16, 16, 16, 16, 16, 16
12, 12, 12, 12, 12,  5,  0,  2, 16, 16, 16, 16, 16, 16, 66, 68, 16, 16, 16, 16, 16, 16,  0,  0,  0,  0,  0,  0,  0,  0,  0, 16, 16, 16, 16,  0,  0,  0,  0, 16, 16, 16, 16, 16, 16, 16, 16, 16, 16, 16
12, 12, 12, 12, 12,  5,  0,  2, 16, 16, 16, 16, 16, 16, 81,  0,  0, 16, 16, 16, 16, 16, 16, 16, 16, 16, 16, 16, 16, 16, 16, 16, 16, 16, 16, 16, 16, 16, 16, 16, 16, 16, 16, 16, 16, 16, 16, 16, 16, 16
12, 12, 12, 12, 12,  5,  0,  2, 16, 16, 16, 16, 16, 16, 81,  0,  0, 16, 16, 16, 16, 16, 16, 16, 16, 16, 16, 16, 16, 16, 16, 16, 16, 16, 16, 16, 16, 16, 16, 16, 16, 16, 16, 16, 16, 16, 16, 16, 16, 16
12, 12, 12, 12, 12,  5,  0,  2, 16, 16, 16, 16, 16, 16, 81,  0,  0, 16, 16, 16, 16, 16, 16, 16, 16, 16, 16, 16, 16, 16, 16, 16, 16, 16, 16, 16, 16, 16, 16, 16, 16, 16, 16, 16, 16, 16, 16, 16, 16, 16
12, 12, 12, 12, 12,  5,  0,  2, 16, 16, 16, 16, 16, 16, 81,  0,  0, 16, 16, 16, 16, 16, 16, 16, 16, 16, 16, 16, 16, 16, 16, 16, 16, 16, 16, 16, 16, 16, 16, 16, 16, 16, 16, 16, 16, 16, 16, 16, 16, 16
12, 12, 12, 12, 12,  5,  0,  2, 16, 16, 16, 16, 16, 16, 81,  0,  0, 16, 16, 16, 16, 16, 16, 16, 16, 16, 16, 16, 16, 16, 16, 16, 16, 16, 16, 16, 16, 16, 16, 16, 16, 16, 16, 16, 16, 16, 16, 16, 16, 16
12, 12, 12, 12, 12,  5,  0,  2, 16, 16, 16, 16, 16, 16, 81,  0,  0, 16, 16, 16, 16, 16, 16, 16, 16, 16, 16, 16, 16, 16, 16, 16, 16, 16, 16, 16, 16, 16, 16, 16, 16, 16, 16, 16, 16, 16, 16, 16, 16, 16
12, 12, 12, 12, 12,  5,  0,  2, 16, 16, 16, 16, 16, 16, 81,  0,  0, 16, 16, 16, 16, 16, 16, 16, 16, 16, 16, 16, 16, 16, 16, 16, 16, 16, 16, 16, 16, 16, 16, 16, 16, 16, 16, 16, 16, 16, 16, 16, 16, 16
12, 12, 12, 12, 12,  5,  0,  2, 16, 16, 16, 16, 16, 16, 81,  0,  0, 16, 16, 16, 16, 16, 16, 16, 16, 16, 16, 16, 16, 16, 16, 16, 16, 16, 16,  0,  0, 16, 16, 16, 16, 16, 16, 16, 16, 16, 16, 16, 16, 16
12, 12, 12, 12, 12,  5,  0,  2, 16, 16, 16, 16, 16, 16, 81,  0,  0, 16, 16, 16, 16, 16, 16, 16, 16, 16, 16, 16, 16, 16, 16, 16, 16, 16, 16,  0,  0, 16, 16, 16, 16, 16, 16, 16, 16, 16, 16, 16, 16, 16
12, 12, 12, 12, 12,  5,  0,  2, 16, 16, 16, 16, 16, 16, 81,  0,  0, 16, 16, 16, 16, 16, 16, 16, 16, 16, 16, 16, 16, 16, 16, 16, 16, 16, 16,  0,  0, 16, 16, 16, 16, 16, 16, 16, 16, 16, 16, 16, 16, 16
12, 12, 12, 12, 12,  5,  0,  2, 16, 16, 16, 16, 16, 16, 81,  0,  0, 16, 16, 16, 16, 16, 16, 16, 16, 16, 16, 16, 16, 16, 16, 16, 16, 16, 16,  0,  0, 16, 16, 16, 16, 16, 16, 16, 16, 16, 16, 16, 16, 16
12, 12, 12, 12, 12,  5,  0,  2, 16, 16, 16, 16, 16, 16, 81,  0,  0, 16, 16, 16, 16, 16, 16, 16, 16, 16, 16, 16, 16, 16, 16, 16, 16, 16, 16,  0,  0, 16, 16, 16, 16, 16, 16, 16, 16, 16, 16, 16, 16, 16
12, 12, 12, 12, 12,  5,  0,  2, 16, 16, 16, 16, 16, 16, 81,  0,  0, 16, 16, 16, 16, 16, 16, 16, 16, 16, 16, 16, 16, 16, 16, 16, 16, 16, 16,  0,  0, 16, 16, 16, 16, 16, 16, 16, 16, 16, 16, 16, 16, 16
12, 12, 12, 12, 12,  5,  0,  2, 16, 16, 16, 16, 16, 16, 63, 64,  0, 16, 16, 16, 16, 16, 16, 16, 16, 16, 16, 16, 16, 16, 16, 16, 16, 16, 16,  0,  0, 16, 16, 16, 16, 16, 16, 16, 16, 16, 16, 16, 16, 16
12, 12, 12, 12, 12,  5,  0,  2, 16, 16, 16, 16, 16, 16, 16, 16, 16, 16, 16, 16, 16, 16, 16, 16, 16, 16, 16, 16, 16, 16, 16, 16, 16, 16, 16,  0,  0, 16, 16, 16, 16, 16, 16, 16, 16, 16, 16, 16, 16, 16
12, 12, 12, 12, 12,  5,  0,  2, 16, 16, 16, 16, 16, 16, 16, 16, 16, 16, 16, 16, 16, 16, 16, 16, 16, 16, 16, 16, 16, 16, 16, 16, 16, 16, 16,  0,  0, 16, 16, 16, 16, 16, 16, 16, 16, 16, 16, 16, 16, 16
12, 12, 12, 12, 12,  5,  0,  2, 16, 16, 16, 16, 16, 16, 16, 16,  2, 16, 16, 16, 16, 16, 16, 16, 16, 16, 16, 16, 16, 16, 16, 16, 16, 16, 16, 16, 16, 16, 16, 16, 16, 16, 16, 16, 16, 16, 16, 16, 16, 16
12, 12, 12, 12, 12,  5,  0,  2, 16, 16, 16, 16, 16, 16, 16, 16,  2, 16, 16, 16, 16, 16, 16, 16, 16, 16, 16, 16, 16, 16, 16, 16, 16, 16, 16, 16, 16, 16, 16, 16, 16, 16, 16, 16, 16, 16, 16, 16, 16, 16
12, 12, 12, 12, 12,  5,  0,  2, 16, 16, 16, 16, 16, 16, 16, 16,  2, 16, 16, 16, 16, 16, 16, 16, 16, 16, 16, 16, 16, 16, 16, 16, 16, 16, 16, 16, 16, 16, 16, 16, 16, 16, 16, 16, 16, 16, 16, 16, 16, 16
12, 12, 12, 12, 12,  5,  0,  2, 16, 16, 16, 16, 16, 16, 66,  2,  2,  0, 81,  0, 16, 16, 16, 16, 16, 16, 16, 16, 16, 16, 16, 16, 16, 16, 16, 16, 16, 16, 16, 16, 16, 16, 16, 16, 16, 16, 16, 16, 16, 16
12, 12, 12, 12, 12,  5,  0,  2, 16, 16, 16, 16, 16, 16, 81, 14,  0,  2,  0,  0, 16, 16, 16, 16, 16, 16, 16, 16, 16, 16, 16, 16, 16, 16, 16, 16, 16, 16, 16, 16, 16, 16, 16, 16, 16, 16, 16, 16, 16, 16
12, 12, 12, 12, 12,  5,  0,  2, 16, 16, 16, 16, 16, 16, 81, 14,  0,  2,  0,  0, 16, 16, 16, 16, 16, 16, 16, 16, 16, 16, 16, 16, 16, 16, 16, 16, 16, 16, 16, 16, 16, 16, 16, 16, 16, 16, 16, 16, 16, 16
12, 12, 12, 12, 12,  5,  0,  2, 16, 16, 16, 16, 16, 16, 81, 14,  0,  2,  2,  0, 16, 16, 16, 16, 16, 16, 16, 16, 16, 16, 16, 16, 16, 16, 16, 16, 16, 16, 16, 16, 16, 16, 16, 16, 16, 16, 16, 16, 16, 16
12, 12, 12, 12, 12,  5,  0,  2, 16, 16, 16, 16, 16, 16, 81, 14,  0,  2,  2,  0, 16, 16, 16, 16, 16, 16, 16, 16, 16, 16, 16, 16, 16, 16, 16, 16, 16, 16, 16, 16, 16, 16, 16, 16, 16, 16, 16, 16, 16, 16
12, 12, 12, 12, 12,  5,  0,  2, 16, 16, 16, 16, 16, 16, 81, 14,  0,  2,  2,  0, 16, 16, 16, 16, 16, 16, 16, 16, 16, 16, 16, 16, 16, 16, 16, 16, 16, 16, 16, 16, 16, 16, 16, 16, 16, 16, 16, 16, 16, 16
12, 12, 12, 12, 12,  5,  0,  2, 16, 16, 16, 16, 16, 16, 81, 14,  0,  2,  2,  0, 16, 16, 16, 16, 16, 16, 16, 16, 16, 16, 16, 16, 16, 16, 16, 16, 16, 16, 16, 16, 16, 16, 16, 16, 16, 16, 16, 16, 16, 16
12, 12, 12, 12, 12,  5,  0,  2, 16, 16, 16, 16, 16, 16, 81, 14,  0,  0,  2,  0, 16, 16, 16, 16, 16, 16, 16, 16, 16, 16, 16, 16, 16, 16, 16, 16, 16, 16, 16, 16, 16, 16, 16, 16, 16, 16, 16, 16, 16, 16
12, 12, 12, 12, 12,  5,  0,  2, 16, 16, 16, 16, 16, 16, 81, 14,  0,  0,  0,  0,  0,  0,  2,  2, 16, 16,  2,  2,  2,  2,  2, 16, 16, 16, 16, 16, 16, 16, 16, 16, 16, 16, 16, 16, 16, 16, 16, 16, 16, 16
12, 12, 12, 12, 12,  5,  0,  2,  5,  5,  5,  5,  5,  5, 63,  2,  0,  0,  0,  0,  0,  0,  2,  2, 16, 16,  2,  2,  2,  2,  2, 16, 16, 16, 16, 16, 16, 16, 16, 16, 16, 16, 16, 16, 16, 16, 16, 16, 16, 16
12, 12, 12, 12, 12,  5,  0,  2,  5,  5,  5,  5,  5,  5,  5,  5,  5,  5,  5,  5,  5,  5,  5,  5, 16, 16,  5,  5,  5,  5,  5, 16, 16, 16, 16, 16, 16, 16, 16, 16, 16, 16, 16, 16, 16, 16, 16, 16, 16, 16
12, 12, 12, 12, 12,  5,  0,  2,  5,  5,  5,  5,  5,  5,  5,  5,  5,  5,  5,  5,  5,  5,  5,  5,  5,  5,  5,  5,  5,  5,  5,  5,  5,  5,  5,  5,  5,  5,  5,  5,  5,  5,  5,  5,  5,  5,  5,  5,  5,  5
12, 12, 12, 12, 12,  5,  0,  2,  5,  5,  5,  5,  5,  5,  5,  5,  5,  5,  5,  5,  5,  5,  5,  5,  5,  5,  5,  5,  5,  5,  5,  5,  5,  5,  5,  5,  5,  5,  5,  5,  5,  5,  5,  5,  5,  5,  5,  5,  5,  5
12, 12, 12, 12, 12,  5,  0,  2,  5,  5,  5,  5,  5,  5,  5,  5,  5,  5,  5,  5,  5,  5,  5,  5,  5,  5,  5,  5,  5,  5,  5,  5,  5,  5,  5,  5,  5,  5,  5,  5,  5,  5,  5,  5,  5,  5,  5,  5,  5,  5
12, 12, 12, 12, 12,  5,  0,  2,  5,  5,  5,  5,  5,  5,  5,  5,  5,  5,  5,  5,  5,  5,  5,  5,  5,  5,  5,  5,  5,  5,  5,  5,  5,  5,  5,  5,  5,  5,  5,  5,  5,  5,  5,  5,  5,  5,  5,  5,  5,  5
12, 12, 12, 12, 12,  5,  0,  2,  5,  5,  5,  5,  5,  5,  5,  5,  5,  5,  5,  5,  5,  5,  5,  5,  5,  5,  5,  5,  5,  5,  5,  5,  5,  5,  5,  5,  5,  5,  5,  5,  5,  5,  5,  5,  5,  5,  5,  5,  5,  5
12, 12, 12, 12, 12,  5,  0,  2,  5,  5,  5,  5,  5,  5,  5,  5,  5,  5,  5,  5,  5,  5,  5,  5,  5,  5,  5,  5,  5,  5,  5,  5,  5,  5,  5,  5,  5,  5,  5,  5,  5,  5,  5,  5,  5,  5,  5,  5,  5,  5
12, 12, 12, 12, 12,  5,  0,  2,  5,  5,  5,  5,  5,  5,  5,  5,  5,  5,  5,  5,  5,  5,  5,  5,  5,  5,  5,  5,  5,  5,  5,  5,  5,  5,  5,  5,  5,  5,  5,  5,  5,  5,  5,  5,  5,  5,  5,  5,  5,  5
12, 12, 12, 12, 12,  5,  5,  5,  5,  5,  5,  5,  5,  5,  5,  5,  5,  5,  5,  5,  5,  5,  5,  5,  5,  5,  5,  5,  5,  5,  5,  5,  5,  5,  5,  5,  5,  5,  5,  5,  5,  5,  5,  5,  5,  5,  5,  5,  5,  5
12, 12, 12, 12, 12, 12, 12, 12, 12, 12, 12, 12, 12, 12, 12, 12, 12, 12, 12, 12, 12, 12, 12, 12, 12, 12, 12, 12, 12, 12,  5,  5,  5,  5,  5,  5,  5,  5,  5,  5,  5,  5,  5,  5,  5,  5,  5,  5,  5,  5
12, 12, 12, 12, 12, 12, 12, 12, 12, 12, 12, 12, 12, 12, 12, 12, 12, 12, 12, 12, 12, 12, 12, 12, 12, 12, 12, 12, 12, 12,  5,  5,  5,  5,  5,  5,  5,  5,  5,  5,  5,  5,  5,  5,  5,  5,  5,  5,  5,  5
12, 12, 12, 12, 12, 12, 12, 12, 12, 12, 12, 12, 12, 12, 12, 12, 12, 12, 12, 12, 12, 12, 12, 12, 12, 12, 12, 12, 12, 12,  5, 16, 16, 16, 16, 16, 16, 16, 16, 16, 16, 16, 16, 16, 16, 16, 16, 16, 16, 16
12, 12, 12, 12, 12, 12, 12, 12, 12, 12, 12, 12, 12, 12, 12, 12, 12, 12, 12, 12, 12, 12, 12, 12, 12, 12, 12, 12, 12, 12, 16, 16, 16, 16, 16, 16, 16, 16, 16, 16, 16, 16, 16, 16, 16, 16, 16, 16, 16, 16
12, 12, 12, 12, 12, 12, 12, 12, 12, 12, 12, 12, 12, 12, 12, 12, 12, 12, 12, 12, 12, 12, 12, 12, 12, 12, 12, 12, 12, 12, 16, 16, 16, 16, 16, 16, 16, 16, 16, 16, 16, 16, 16, 16, 16, 16, 16, 16, 16, 16
12, 12, 12, 12, 12, 12, 12, 12, 12, 12, 12, 12, 12, 12, 12, 12, 12, 12, 12, 12, 12, 12, 12, 12, 12, 12, 12, 12, 12, 12, 16, 16, 16, 16, 16, 16, 16, 16, 16, 16, 16, 16, 16, 16, 16, 16, 16, 16, 16, 16