-1, -1, -1, -1, -1,500, -1,503, -1, -1, -1, -1, -1, -1, -1, -1, -1, -1, -1, -1, -1, -1, -1, -1, -1, -1, -1, -1, -1, -1, -1, -1,999,999,999,999,559,999,999,999,999, -1, -1, -1, -1, -1, -1, -1, -1, -1
  1, -1, -1, -1, -1,501, -1,506, -1, -1, -1, -1, -1, -1, -1, -1, -1, -1, -1, -1, -1, -1, -1, -1, -1, -1, -1, -1, -1, -1, -1, -1,999,999, -1, -1, -1, -1,999, -1,999, -1, -1, -1, -1, -1, -1, -1, -1, -1
  1, -1, -1, -1, -1,501, -1,506, -1, -1, -1, -1, -1, -1, -1, -1, -1, -1, -1, -1, -1, -1,561, -1, -1, -1, -1, -1, -1, -1, -1, -1,999,999, -1, -1,554, -1,999, -1,999, -1, -1, -1, -1, -1, -1, -1, -1, -1
 -1, -1, -1, -1, -1,501, -1,506, -1, -1, -1, -1, -1, -1, -1, -1, -1, -1, -1, -1, -1, -1, -1, -1, -1, -1, -1, -1, -1, -1, -1, -1,999,999, -1, -1, -1, -1,999, -1,999, -1, -1, -1, -1, -1, -1, -1, -1, -1
 -1, -1, -1, -1, -1,501,505,506, -1, -1, -1, -1, -1, -1, -1, -1, -1, -1, -1, -1, -1, -1, -1, -1, -1, -1, -1, -1, -1, -1, -1, -1,999,999, -1, -1, -1, -1,999, -1,999, -1, -1, -1, -1, -1, -1, -1, -1, -1  
 -1, -1, -1, -1, -1,501,507,506, -1, -1, -1, -1, -1, -1, -1, 69, -1,508, -1,999,999,999,999,999,999,999,999, -1, -1, -1, -1, -1,999,999, -1, -1, -1, -1,999, -1,999, -1, -1, -1, -1, -1, -1, -1, -1, -1
 -1, -1, -1, -1, -1,501,505,506, -1, -1, -1, -1, -1, -1, -1, 68, -1, -1, -1,999,999,999,555,999,999,999,999, -1, -1, -1, -1, -1,999,999, -1, -1, -1, -1,999, -1,999, -1, -1, -1, -1, -1, -1, -1, -1, -1
 -1, -1, -1, -1, -1,501, -1,506, -1, -1, -1, -1, -1, -1, -1, 68, -1, -1, -1,999, -1, -1, -1, -1, -1, -1,999, -1, -1, -1, -1, -1,999,999, -1, -1, -1, -1,999, -1,999, -1, -1, -1, -1, -1, -1, -1, -1, -1
  1, -1, -1, -1, -1,501,505,506, -1, -1, -1, -1, -1, -1, -1, 68, -1, -1, -1,999,999,999, -1,999,999,999,999, -1, -1, -1, -1, -1,999,999, -1, -1, -1, -1,999, -1,999, -1, -1, -1, -1, -1, -1, -1, -1, -1
 -1, -1, -1, -1, -1,501,507,506, -1, -1, -1, -1, -1, -1, -1, 66, -1, -1, -1, -1, -1, -1, -1, -1, -1, -1, -1, -1, -1, -1, -1, -1,999,999, -1, -1, -1, -1,999, -1,999, -1, -1, -1, -1, -1, -1, -1, -1, -1
 -1, -1, -1, -1, -1,501,505,506, -1, -1, -1, -1, -1, -1, -1, -1, 63, 65,503, -1, -1, -1, -1, -1, -1, -1, -1, -1, -1, -1, -1, -1,999,999,990,999,999,999,999,999,999, -1, -1, -1, -1, -1, -1, -1, -1, -1
  1, -1, -1, -1, -1,501, -1,506, -1, -1, -1, -1, -1, -1, -1, -1, -1, -1,506,509,509,509,509,509,509,504, -1, -1, -1, -1, -1, -1, -1, -1, -1, 70, -1, -1,505, -1, -1, -1, -1, -1, -1, -1, -1, -1, -1, -1
 -1, -1, -1, -1, -1,501,505,506, -1, -1, -1, -1, -1, -1, -1, -1, -1, -1,506, -1, -1, -1, -1, -1, -1, -1, -1, -1, -1, -1, -1, -1, -1, -1, -1, 70,505, 70, 61, -1, -1, -1, -1, -1, -1, -1, -1, -1, -1, -1
 -1, -1, -1, -1, -1,501,507,506, -1, -1, -1, -1, -1, -1, -1, -1,500,509,504, -1, -1, -1, -1, -1, -1, -1, -1, -1, -1, -1, -1, -1, -1, -1, -1, 61, 61, 61, 61, -1, -1, -1, -1, -1, -1, -1, -1, -1, -1, -1
 -1, -1, -1, -1, -1,501,505,506, -1, -1, -1, -1, -1, -1, -1, -1, 79, -1, -1, -1, -1, -1, -1, -1, -1,999, 73,999, -1, -1,557, -1, -1, -1, -1, -1, -1, -1, -1, -1, -1, -1, -1, -1, -1, 78, -1, -1, 78, -1
 -1, -1, -1, -1, -1,501, -1,506, -1, -1, -1, -1, -1, -1, -1, -1, -1, -1, -1, -1, -1, -1, -1, -1, -1, -1, -1, -1, -1, -1, -1, -1, -1, -1, -1, -1, -1, -1, -1, -1, -1, -1, -1, -1, -1, -1, -1, -1, -1, -1
 -1, -1, -1, -1, -1,501,505,506, -1, -1, -1, -1, -1, -1, -1, -1, -1, -1, -1, -1, -1, -1, -1, -1, -1, -1, -1, -1, -1, -1, -1, -1, -1,103, -1, -1, -1, -1, -1, -1, -1, -1, -1, -1, -1, 78, -1, -1, 78, -1
 -1, -1, -1, -1, -1,501,507,506, -1, -1, -1, -1, -1, -1, -1, -1, -1, -1, -1, -1, -1, -1, -1, -1, -1, -1, -1, -1, -1, -1, -1, -1, -1, -1, -1, -1, -1, -1, -1, -1, -1, -1, -1, -1, -1, -1, -1, -1, -1, -1
 -1, -1, -1, -1, -1,501,505,506, -1, -1, -1, -1, -1, -1, -1, -1, -1, -1, -1, -1, -1, -1, -1, -1, -1, -1, -1, -1, -1, -1, -1, -1, -1, -1, -1, -1, -1, -1, -1, -1, -1, -1, -1, -1, -1, -1, -1, -1, -1, -1
 -1, -1, -1, -1, -1,501, -1,506, -1, -1, -1, -1, -1, -1, -1, -1, -1, -1, -1, -1, -1, -1, -1, 77, -1, -1, 77, -1, -1, 77, -1, -1, -1, -1, -1, 60, 61, 61, 61, -1, -1, -1, -1, -1, -1, -1, -1, -1, -1, -1
 -1, -1, -1, -1, -1,501,505,506, -1, -1, -1, -1, -1, -1, -1, -1, 79, -1, -1, -1, -1, -1, -1, -1, -1, -1, -1, -1, -1, -1, -1, -1, -1, -1, -1, -1, -1, 61, 61, -1, -1, -1, 83, -1, -1, -1, -1, -1, -1, -1
 -1, -1, -1, -1, -1,501,507,506, -1, -1, -1, -1, -1, -1, -1, -1,501, -1, -1, 558, -1, -1, -1, -1, -1, -1, -1, -1, -1, -1, -1, -1, -1, -1, -1, 61, 61, 61, 61, -1, -1, -1, -1, -1, -1, -1, -1, -1, -1, -1
 -1, -1, -1, -1, -1,501,505,506, -1, -1, -1, -1, -1, -1, -1,505,501, -1, -1, -1, -1, -1, -1, -1, -1, -1, -1, -1, -1, -1, -1, -1, -1, -1, -1, -1, -1, -1, -1, -1, -1, -1, -1, -1, -1, -1, -1, -1, -1, -1
 -1, -1, -1, -1, -1,501, -1,506, -1, -1, -1, -1, -1, -1, -1,505,501, -1, -1, -1, -1, -1, -1, -1, -1, -1, -1, -1, -1, -1, -1, -1, -1, -1, -1, -1, -1, -1, -1, -1, -1, -1, -1, -1, -1, -1, -1, -1, -1, -1
 -1, -1, -1, -1, -1,501,505,506, -1, -1, -1, -1, -1, -1, -1, 61,501, -1, -1, -1, -1, -1, -1, -1, -1, -1, -1, -1, -1, -1, -1, -1, -1, -1, -1, -1, -1, -1, -1, -1, -1, -1, -1, -1, -1, -1, -1, -1, -1, -1
 -1, -1, -1, -1, -1,501,507,506, -1, -1, -1, -1, -1, -1, -1,505,501, -1, -1, -1, -1, -1, -1, -1, -1, -1, -1, -1, -1, -1, -1, -1, -1, -1, -1, -1, -1, -1, -1, -1, -1, -1, -1, -1, -1, -1, -1, -1, -1, -1
 -1, -1, -1, -1, -1,501,505,506, -1, -1, -1, -1, -1, -1, -1, 61,501,999,999,999,999,999,550,999,999,999,999,999,999, -1, -1, -1, -1, -1, -1, -1, -1, -1, -1, -1, -1, -1, -1, -1, -1, -1, -1, -1, -1, -1
 -1, -1, -1, -1, -1,501, -1,506, -1, -1, -1, -1, -1, -1, -1,505,501, -1, -1, -1, -1, -1, -1, -1, -1, -1, -1, -1,999, -1, -1, -1, -1, -1, -1, -1, -1, -1, -1, -1, -1, -1, -1, -1, -1, -1, -1, -1, -1, -1
 -1, -1, -1, -1, -1,501,505,506, -1, -1, -1, -1, -1, -1, -1,505,501, -1, 77, -1, 77, -1, 77, -1, 77, -1, 77, -1,999, -1, -1, -1, -1, -1, -1, -1, -1, -1, -1, -1, -1, -1, -1, -1, -1, -1, -1, -1, -1, -1
 -1, -1, -1, -1, -1,501,507,506, -1, -1, -1, -1, -1, -1, -1, 70,501,999,999,999,999,999,999,999,999,999,999,999,999, -1, -1, -1, -1, -1, -1, -1, -1, -1, -1, -1, -1, -1, -1, -1, -1, -1, -1, -1, -1, -1
 -1, -1, -1, -1, -1,501,505,506, -1, -1, -1, -1, -1, -1, -1, 70,501, -1, -1, -1, -1, -1, -1, -1, -1, -1, -1, -1,990, -1, -1, -1, -1, -1, -1, 77, -1, -1, -1, -1, -1, -1, -1, -1, -1, -1, -1, -1, -1, -1
 -1, -1, -1, -1, -1,501, -1,506, -1, -1, -1, -1, -1, -1, -1,505,501,999,999,999,999,999,553,999,999,999,999,999,999, -1, -1, -1, -1, -1, -1, -1, -1, -1, -1, -1, -1, -1, -1, -1, -1, -1, -1, -1, -1, -1
 -1, -1, -1, -1, -1,501,505,506, -1, -1, -1, -1, -1, -1, -1, 70,501,999,999,999,999,999,999,999,999,999,999,999,999, -1, -1, -1, -1, -1, -1, 77, -1, -1, -1, -1, -1, -1, -1, -1, -1, -1, -1, -1, -1, -1
 -1, -1, -1, -1, -1,501,507,506, -1, -1, -1, -1, -1, -1, -1, 70,501,999,999,999,999,999,999,999,999,999,999,999,999, -1, -1, -1, -1, -1, -1, -1, -1, -1, -1, -1, -1, -1, -1, -1, -1, -1, -1, -1, -1, -1
 -1, -1, -1, -1, -1,501,505,506, -1, -1, -1, -1, -1, -1, -1,505,501, -1,508, -1, -1, -1, -1, -1, -1, -1, -1, -1, -1, -1, -1, -1, -1, -1, -1, -1, -1, -1, -1, -1, -1, -1, -1, -1, -1, -1, -1, -1, -1, -1
 -1, -1, -1, -1, -1,501, -1,506, -1, -1, -1, -1, -1, -1, -1, -1,502, -1, -1, -1, -1, -1, 83, -1, -1, -1, -1, -1, -1, -1, -1, -1, -1, -1, -1, -1, -1, -1, -1, -1, -1, -1, -1, -1, -1, -1, -1, -1, -1, -1
 -1, -1, -1, -1, -1,501,505,506, -1, -1, -1, -1, -1, -1, -1, -1, -1, -1, -1, -1, -1, -1, -1, -1,103, -1, -1, -1, -1, -1, -1, -1, -1, -1, -1, 77, -1, -1, -1, -1, -1, -1, -1, -1, -1, -1, -1, -1, -1, -1
 -1, -1, -1, -1, -1,501,507,506, -1, -1, -1, -1, -1, -1, -1, -1, -1, -1, -1, -1, -1, -1, -1, -1, -1, -1, -1, -1, -1, -1, -1, -1, -1, -1, -1, -1, -1, -1, -1, -1, -1, -1, -1, -1, -1, -1, -1, -1, -1, -1
 -1, -1, -1, -1, -1,501,505,506, -1, -1, -1, -1, -1, -1, -1, -1,500, -1, -1, -1, -1, -1, -1, -1, -1, -1, -1, -1, -1, -1, -1, -1, -1, -1, -1, -1, -1, -1, -1, -1, -1, -1, -1, -1, -1, -1, -1, -1, -1, -1
 -1, -1, -1, -1, -1,501, -1,506, -1, -1, -1, -1, -1, -1, -1, -1,501, -1, -1, -1, -1, -1, -1, -1, -1, -1, -1, -1, -1, -1, -1, -1, -1, -1, -1, -1, -1, -1, -1, -1, -1, -1, -1, -1, -1, -1, -1, -1, -1, -1
 -1, -1, -1, -1, -1,501,505,506, -1, -1, -1, -1, -1, -1, -1, -1,502, -1, -1, -1, -1, -1, -1, -1, -1, -1, -1, -1, -1, -1, -1, -1, -1, -1, -1, -1, -1, -1, -1, -1, -1, -1, -1, -1, -1, -1, -1, -1, -1, -1
 -1, -1, -1, -1, -1,501,507,506, -1, -1, -1, -1, -1, -1, -1, 81,508, -1, -1, -1, -1, -1, -1, -1, -1, -1, -1, -1, -1, -1, -1,563, -1, -1, -1, -1, -1, -1, -1, -1, -1, -1, -1, -1, -1, -1, -1, -1, -1, -1
 -1, -1, -1, -1, -1,501,505,506, -1, -1, -1, -1, -1, -1, -1, 70, -1, -1, -1, -1, -1, -1, -1, 562,-1, -1, -1, -1, -1, -1, -1, -1, -1, -1, -1, -1, -1,564, -1, -1, -1, -1, -1, -1, -1, -1, -1, -1, -1, -1
 -1, -1, -1, -1, -1,501, -1,506, -1, -1, -1, -1, -1, -1, -1, 70,505, -1, -1, -1, -1, -1, -1, -1, -1, -1, -1, -1, -1, -1, -1, -1, -1, -1, -1, -1, -1, -1, -1, -1, -1, -1, -1, -1, -1, -1, -1, -1, -1, -1
 -1, -1, -1, -1, -1,501,505,506, -1, -1, -1, -1, -1, -1, -1, 70, 61, -1, -1, -1, -1, -1, -1, -1, -1, -1, -1,103, -1, -1, -1, -1, -1, -1, -1, -1, -1, -1, -1, -1, -1, -1, -1, -1, -1, -1, -1, -1, -1, -1
 -1, -1, -1, -1, -1,501,507,506, -1, -1, -1, -1, -1, -1, -1, 70, 61, -1, -1, -1, -1, -1, -1, 551,-1, -1, -1, -1, -1, -1, -1, -1, -1, -1, -1, -1, -1, -1, -1, -1, -1, -1, -1, -1, -1, -1, -1, -1, -1, -1
 -1, -1, -1, -1, -1,501,505,506, -1, -1, -1, -1, -1,103, -1, 70, -1, -1,556, -1, -1, -1, -1,-1,  -1, -1, -1, -1, 508,-1, -1,508, -1, -1, -1, -1, -1, -1, -1, -1, -1, -1, -1, -1, -1, -1, -1, -1, -1, -1
 -1, -1, -1, -1, -1,501, -1,506, -1, -1, -1, -1, -1, -1, -1, 70, -1, -1, -1, -1,508, -1, -1, 60, -1, -1, 60, -1, 60, -1, 60, -1, -1, 60, -1, -1, -1, -1, -1, -1, -1, -1, -1, -1, -1, -1, -1, -1, -1, -1
 -1, -1, -1, -1, -1,501,505,506, -1, -1, -1, -1, -1, -1, -1, 70, 60, 70, -1, -1, -1, -1, -1, -1, -1, -1, -1, -1, -1, -1, -1, -1, -1, -1, -1, -1, -1, -1, -1, -1, -1, -1, -1, -1, -1, -1, -1, -1, -1, -1
 -1, -1, -1, -1, -1,501,507,506, -1, -1, -1, -1, -1, -1, -1, 70, 61, -1, -1, 81, 81, 81, 81, 80, -1, -1, 63, 81, 81, 81, 81, 81, 81, 80, -1, -1, -1, -1, -1, -1, -1, -1, -1, -1, -1, -1, -1, -1, -1, -1
 -1, -1, -1, -1, -1,501,505,506, -1, -1, -1, -1, -1, -1, -1, 64, 64, 64, 64, 64, 64, 64, 64, 65, -1, -1, 66, 64, 64, 64, 64, 64, 64, 65, -1, -1, -1, -1, -1, -1, -1, -1, -1, -1, -1, -1, -1, -1, -1, -1
 -1, -1, -1, -1, -1,501, -1,506, -1, -1, -1, -1, -1, -1, -1, -1,999,999,999,999, -1, -1, -1, -1, -1, -1, -1, -1, -1, -1, -1, -1, -1, -1, -1, -1, -1, -1, -1, -1, -1, -1, -1, -1, -1, -1, -1, -1, -1, -1
 -1, -1, -1, -1, -1,501,505,506, -1, -1, -1, -1, -1, -1, -1,990,999,999,999,999, -1, -1, -1, -1, -1, -1, -1, -1, -1, -1, -1, -1, -1, -1, -1, -1, -1, -1, -1, -1, -1, -1, -1, -1, -1, -1, -1, -1, -1, -1
 -1, -1, -1, -1, -1,501,507,506, -1, -1, -1, -1, -1, -1, -1, -1,999, 16,999,999, -1, -1, -1, -1, -1, -1, -1, -1, -1, -1, -1, -1, -1, -1, -1, -1, -1, -1, -1, -1, -1, -1, -1, -1, -1, -1, -1, -1, -1, -1
 -1, -1, -1, -1, -1,501,505,506, -1, -1, -1, -1, -1, -1, -1, -1, -1, -1, -1, -1, -1, -1, -1, -1, -1, -1, -1, -1, -1, -1, -1, -1, -1, -1, -1, -1, -1, -1, -1, -1, -1, -1, -1, -1, -1, -1, -1, -1, -1, -1
 -1, -1, -1, -1, -1,501, -1,506, -1, -1, -1, -1, -1, -1, -1, -1, -1, -1, -1, -1, -1, -1, -1, -1, -1, -1, -1, -1, -1, -1, -1, -1, -1, -1, -1, -1, -1, -1, -1, -1, -1, -1, -1, -1, -1, -1, -1, -1, -1, -1
 -1, -1, -1, -1, -1,501,505,506, -1, -1, -1, -1, -1, -1, -1, -1, -1, -1, -1, -1, -1, -1, -1, -1, -1, -1, -1, -1, -1, -1, -1, -1, -1, -1, -1, -1, -1, -1, -1, -1, -1, -1, -1, -1, -1, -1, -1, -1, -1, -1
 -1, -1, -1, -1, -1,501,507,506, -1, -1, -1, -1, -1, -1, -1, -1, -1, -1, -1, -1, -1, -1, -1, -1, -1, -1, -1, -1, -1, -1, -1, -1, -1, -1, -1, -1, -1, -1, -1, -1, -1, -1, -1, -1, -1, -1, -1, -1, -1, -1
 -1, -1, -1, -1, -1,501,505,506, -1, -1, -1, -1, -1, -1, -1, -1, -1, -1, -1, -1, -1, -1, -1, -1, -1, -1, -1, -1, -1, -1, -1, -1, -1, -1, -1, -1, -1, -1, -1, -1, -1, -1, -1, -1, -1, -1, -1, -1, -1, -1
 -1, -1, -1, -1, -1,502, -1,504, -1, -1, -1, -1, -1, -1, -1, -1, -1, -1, -1, -1, -1, -1, -1, -1, -1, -1, -1, -1, -1, -1, -1, -1, -1, -1, -1, -1, -1, -1, -1, -1, -1, -1, -1, -1, -1, -1, -1, -1, -1, -1
 -1, -1, -1, -1, -1, -1, -1, -1, -1, -1, -1, -1, -1, -1, -1, -1, -1, -1, -1, -1, -1, -1, -1, -1, -1, -1, -1, -1, -1, -1, -1, -1, -1, -1, -1, -1, -1, -1, -1, -1, -1, -1, -1, -1, -1, -1, -1, -1, -1, -1
 -1, -1, -1, -1, -1, -1, -1, -1, -1, -1, -1, -1, -1, -1, -1, -1, -1, -1, -1, -1, -1, -1, -1, -1, -1, -1, -1, -1, -1, -1, -1, -1, -1, -1, -1, -1, -1, -1, -1, -1, -1, -1, -1, -1, -1, -1, -1, -1, -1, -1
 -1, -1, -1, -1, -1, -1, -1, -1, -1, -1, -1, -1, -1, -1, -1, -1, -1, -1, -1, -1, -1, -1, -1, -1, -1, -1, -1, -1, -1, -1, -1, -1, -1, -1, -1, -1, -1, -1, -1, -1, -1, -1, -1, -1, -1, -1, -1, -1, -1, -1
 -1, -1, -1, -1, -1, -1, -1, -1, -1, -1, -1, -1, -1, -1, -1, -1, -1, -1, -1, -1, -1, -1, -1, -1, -1, -1, -1, -1, -1, -1, -1, -1, -1, -1, -1, -1, -1, -1, -1, -1, -1, -1, -1, -1, -1, -1, -1, -1, -1, -1
 -1, -1, -1, -1, -1, -1, -1, -1, -1, -1, -1, -1, -1, -1, -1, -1, -1, -1, -1, -1, -1, -1, -1, -1, -1, -1, -1, -1, -1, -1, -1, -1, -1, -1, -1, -1, -1, -1, -1, -1, -1, -1, -1, -1, -1, -1, -1, -1, -1, -1
 -1, -1, -1, -1, -1, -1, -1, -1, -1, -1, -1, -1, -1, -1, -1, -1, -1, -1, -1, -1, -1, -1, -1, -1, -1, -1, -1, -1, -1, -1, -1, -1, -1, -1, -1, -1, -1, -1, -1, -1, -1, -1, -1, -1, -1, -1, -1, -1, -1, -1